17:14
 : : : : : : : : : : : : : : : :
 : : : : :⚑:⚑:⚑:⚑:⚑: : : : : : :
 : : : : :⚑: : : :⚑: :WALL:IS:YOU: : :
 : : : : :⚑: :BABA: :⚑: : : : : : :
 : : : : :⚑: : : :⚑: : : : : : :
 :⚑:⚑:⚑:⚑:⚑: : : :⚑:⚑:⚑:⚑:⚑:⚑:⚑:
 :⚑: : : : : : : :⚑: : : : : :⚑:
 :⚑: :IS: : : : : :⚑: :FLAG:IS:STOP: :⚑:
 :⚑: : : : : : : :⚑: : : : : :⚑:
 :⚑: : : : : : : :⚑: : : : :⚑:⚑:
 :⚑: : : :WIN: : : :⚑: : :■: :⚑: :
 :⚑: : : : : : : :⚑: : : : :⚑: :
 :⚑:⚑:⚑:⚑:⚑:⚑:⚑:⚑:⚑:⚑:⚑:⚑:⚑:⚑: :
 : : : : : : : : : : : : : : : :