17:14
 : : : : : : : : : : : : : : : :
 : : : : :■:■:■:■:■: : : : : : :
 : : : : :■: : : :■: :BABA:IS:YOU: : :
 : : : : :■: :FLAG: :■: : : : : : :
 : : : : :■: : : :■: : : : : : :
 :■:■:■:■:■: : : :■:■:■:■:■:■:■:
 :■: : : : : : : :■: : : : : :■:
 :■: :IS: : : :⚑: :■: :WALL:IS:STOP: :■:
 :■: : : : : : : :■: : : : : :■:
 :■: : : : : : : :■: : :X: : :■:
 :■: : : :WIN: : : :■: : : : : :■:
 :■: : : : : : : :■: : : : : :■:
 :■:■:■:■:■:■:■:■:■:■:■:■:■:■:■:
 : : : : : : : : : : : : : : : :