14:17
 : : : : : : : : : : : : :
 : : : : :⚑:⚑:⚑:⚑:⚑:⚑:⚑:⚑:
 : : : : :⚑: : : : : : :⚑:
 : : : : :⚑: :IS: : : : :⚑:
 : : : : :⚑: : : : : : :⚑:
 :⚑:⚑:⚑:⚑:⚑: : : : :WIN: :⚑:
 :⚑: : : : : : : : : : :⚑:
 :⚑: :BABA: : : : : : : : :⚑:
 :⚑: : : : : : : : : : :⚑:
 :⚑:⚑:⚑:⚑:⚑:⚑:⚑:⚑:⚑:⚑:⚑:⚑:
 : : : : :⚑: : : : : : :⚑:
 : :WALL: : :⚑: :FLAG: : : : :⚑:
 : :IS: : :⚑: :IS: : :■: :⚑:
 : :YOU: : :⚑: :STOP: : : : :⚑:
 : : : : :⚑: : : :⚑:⚑:⚑:⚑:
 : : : : :⚑:⚑:⚑:⚑:⚑: : : :
 : : : : : : : : : : : : :