14:16
 : : : : : : : : : : : : :
 : : : : :■:■:■:■:■:■:■:■:
 : : : : :■: : : : : : :■:
 : : : : :■: :IS : : : : :■:
 : : : : :■: : : : : : :■:
 :■:■:■:■:■: : : : :WIN : :■:
 :■: : : : : : : : : : :■:
 :■: :FLAG: : : :F: : : : :■:
 :■: : : : : : : : : : :■:
 :■:■:■:■:■:■:■:■:■:■:■:■:
 : : : : :■: : : : : : :■:
 : :BABA: : :■: :WALL : : : : :■:
 : :IS: : :■: :IS: :X: : :■:
 : :YOU: : :■: :STOP: : : : :■:
 : : : : :■: : : : : : :■:
 : : : : :■:■:■:■:■:■:■:■:
 : : : : : : : : : : : : :