14:17
 : : : : : : : : : : : : :
 : : : : :F:F:F:F:F:F:F:F:
 : : : : :F: : : : : : :F:
 : : : : :F: :IS: : : : :F:
 : : : : :F: : : : : : :F:
 :F:F:F:F:F: : : : :WIN: :F:
 :F: : : : : : : : : : :F:
 :F: :BABA: : : : : : : : :F:
 :F: : : : : : : : : : :F:
 :F:F:F:F:F:F:F:F:F:F:F:F:
 : : : : :F: : : : : : :F:
 : :WALL: : :F: :FLAG: : : : :F:
 : :IS: : :F: :IS: : :■: :F:
 : :YOU: : :F: :STOP: : : : :F:
 : : : : :F: : : :F:F:F:F:
 : : : : :F:F:F:F:F: : : :
 : : : : : : : : : : : : :