13:11
 : : : : : : : : : : : :
 :BABA:IS:YOU: : : : : :FLAG:IS:WIN:
 : : : : : : : : : : : :
 :■:■:■:■:■:■:■:■:■:■:■:
 : : : : : :*: : : : : :
 : :X: : : :*: : : :⚑: :
 : : : : : :*: : : : : :
 :■:■:■:■:■:■:■:■:■:■:■:
 : : : : : : : : : : : :
 :WALL:IS:STOP: : : : : :ROCK:IS:PUSH:
 : : : : : : : : : : : :